7 9
#########
#S#.....#
#.#.###.#
#.#.#G#.#
#...###.#
#####...#
#########
