5 9
#########
#S.....G#
#.#####.#
#.......#
#########
