5 7
#######
#S...G#
#.###.#
#....#
#######
