10 12
############
#S.........#
#.########.#
#.#......#.#
#.#.####.#.#
#.#.#..#.#.#
#...##.#...#
###.##.###.#
#......#..G#
############
